11111111111111111111111111111111111111111111111111111111111111111111111111111111111111111111111111111111111111111111111111111111
11111111111111111111111111111111111111111111111111111111111111111111111111111111111111111111111111111111111111111111111111111111
11111111111111111111111111111111111111111111111111111111111111111111111111111111111111111111111111111111111111111111111111111111
11111111111111111111111111111111111111111111111111111111111111111111111111111111111111111111111111111111111111111111111111111111
00000000111100001111000000000000000000001111000000000000000000000000000011110000000000000000000000000000000000000000000000000000
00000000111100001111000000000000000000001111000000000000000000000000000011110000000000000000000000000000000000000000000000000000
00000000111100001111000000000000000000001111000000000000000000000000000011110000000000000000000000000000000000000000000000000000
00000000111100001111000000000000000000001111000000000000000000000000000011110000000000000000000000000000000000000000000000000000
11110000111100001111111111111111111100001111111111110000111100001111111111111111111111111111111111111111111111111111111111110000
11110000111100001111111111111111111100001111111111110000111100001111111111111111111111111111111111111111111111111111111111110000
11110000111100001111111111111111111100001111111111110000111100001111111111111111111111111111111111111111111111111111111111110000
11110000111100001111111111111111111100001111111111110000111100001111111111111111111111111111111111111111111111111111111111110000
11110000000000001111000000000000000000000000000011110000111100001111000011110000111100000000000011110000000000000000000000000000
11110000000000001111000000000000000000000000000011110000111100001111000011110000111100000000000011110000000000000000000000000000
11110000000000001111000000000000000000000000000011110000111100001111000011110000111100000000000011110000000000000000000000000000
11110000000000001111000000000000000000000000000011110000111100001111000011110000111100000000000011110000000000000000000000000000
11111111111100001111000011110000111111111111111111111111111100001111000011110000111100001111000011110000111111111111111111110000
11111111111100001111000011110000111111111111111111111111111100001111000011110000111100001111000011110000111111111111111111110000
11111111111100001111000011110000111111111111111111111111111100001111000011110000111100001111000011110000111111111111111111110000
11111111111100001111000011110000111111111111111111111111111100001111000011110000111100001111000011110000111111111111111111110000
11110000111100001111000011110000111100001111000011110000111100001111000011110000000000001111000011110000111100000000000000000000
11110000111100001111000011110000111100001111000011110000111100001111000011110000000000001111000011110000111100000000000000000000
11110000111100001111000011110000111100001111000011110000111100001111000011110000000000001111000011110000111100000000000000000000
11110000111100001111000011110000111100001111000011110000111100001111000011110000000000001111000011110000111100000000000000000000
11110000111100001111000011111111111100001111000011110000111100001111000011111111111111111111000011111111111111111111111111110000
11110000111100001111000011111111111100001111000011110000111100001111000011111111111111111111000011111111111111111111111111110000
11110000111100001111000011111111111100001111000011110000111100001111000011111111111111111111000011111111111111111111111111110000
11110000111100001111000011111111111100001111000011110000111100001111000011111111111111111111000011111111111111111111111111110000
11110000000000000000000000000000111100001111000011110000111100001111000011110000000000000000000011110000000000000000000000000000
11110000000000000000000000000000111100001111000011110000111100001111000011110000000000000000000011110000000000000000000000000000
11110000000000000000000000000000111100001111000011110000111100001111000011110000000000000000000011110000000000000000000000000000
11110000000000000000000000000000111100001111000011110000111100001111000011110000000000000000000011110000000000000000000000000000
11111111111100001111111111111111111100001111000011110000111100001111000011111111111111111111000011111111111111111111111111110000
11111111111100001111111111111111111100001111000011110000111100001111000011111111111111111111000011111111111111111111111111110000
11111111111100001111111111111111111100001111000011110000111100001111000011111111111111111111000011111111111111111111111111110000
11111111111100001111111111111111111100001111000011110000111100001111000011111111111111111111000011111111111111111111111111110000
11110000111100001111000000000000111100000000000011110000000000000000000011110000111100001111000000000000000000001111000000000000
11110000111100001111000000000000111100000000000011110000000000000000000011110000111100001111000000000000000000001111000000000000
11110000111100001111000000000000111100000000000011110000000000000000000011110000111100001111000000000000000000001111000000000000
11110000111100001111000000000000111100000000000011110000000000000000000011110000111100001111000000000000000000001111000000000000
11110000111100001111000011111111111100001111111111111111111111111111000011110000111100001111000011110000111100001111111111110000
11110000111100001111000011111111111100001111111111111111111111111111000011110000111100001111000011110000111100001111111111110000
11110000111100001111000011111111111100001111111111111111111111111111000011110000111100001111000011110000111100001111111111110000
11110000111100001111000011111111111100001111111111111111111111111111000011110000111100001111000011110000111100001111111111110000
11110000000000000000000000000000000000000000000011110000000000000000000000000000000000001111000011110000111100001111000000000000
11110000000000000000000000000000000000000000000011110000000000000000000000000000000000001111000011110000111100001111000000000000
11110000000000000000000000000000000000000000000011110000000000000000000000000000000000001111000011110000111100001111000000000000
11110000000000000000000000000000000000000000000011110000000000000000000000000000000000001111000011110000111100001111000000000000
11111111111100001111111111110000111111111111111111111111111100001111111111111111111111111111000011111111111111111111111111110000
11111111111100001111111111110000111111111111111111111111111100001111111111111111111111111111000011111111111111111111111111110000
11111111111100001111111111110000111111111111111111111111111100001111111111111111111111111111000011111111111111111111111111110000
11111111111100001111111111110000111111111111111111111111111100001111111111111111111111111111000011111111111111111111111111110000
11110000000000000000000011110000000000000000000000000000000000000000000000000000000000000000000000000000000000000000000011110000
11110000000000000000000011110000000000000000000000000000000000000000000000000000000000000000000000000000000000000000000011110000
11110000000000000000000011110000000000000000000000000000000000000000000000000000000000000000000000000000000000000000000011110000
11110000000000000000000011110000000000000000000000000000000000000000000000000000000000000000000000000000000000000000000011110000
11111111111100001111111111110000111111111111000011111111111100001111000011111111111100001111000011111111111111111111000011110000
11111111111100001111111111110000111111111111000011111111111100001111000011111111111100001111000011111111111111111111000011110000
11111111111100001111111111110000111111111111000011111111111100001111000011111111111100001111000011111111111111111111000011110000
11111111111100001111111111110000111111111111000011111111111100001111000011111111111100001111000011111111111111111111000011110000
11110000000000001111000000000000111100000000000000000000111100001111000011110000000000001111000011110000000000000000000000000000
11110000000000001111000000000000111100000000000000000000111100001111000011110000000000001111000011110000000000000000000000000000
11110000000000001111000000000000111100000000000000000000111100001111000011110000000000001111000011110000000000000000000000000000
11110000000000001111000000000000111100000000000000000000111100001111000011110000000000001111000011110000000000000000000000000000
